# My Playlist
# Alternative
After Dark X The Perfect Girl - $$ 
Bite My Tongue - $$
Danger - South Arcade $$
Drive - Incubus $$
Fell On Black Days - Soundgarden $$
Lanterns - Greaver $$
Moth Kids - South Arcade $$
Outside - Staind $$
Satisfaction - () $$
Supermassive Black Hole - Muse (Violet Orlandi) $$
Teardrop - Massive Attack (Aurora) $$
Toxic X House Of Flies - Britney Spears X Deaftones $$
# Pop
A Horse With No Name - (Michelle Branch) $$
Bye Bye Bye - NSYNC $$
Careless Wisper - (Seether) $$
Decode - Paramore (Lollia) $$
In The Air Tonight - Phil Collins (Chris Daughtry, Brad Arnold) $$
Just The Two Of Us - Bill Withers $$
How Soon Is Now - The Smiths $$
Major Tom - (I H8 Kate) $$
Mirrors - Justin Timberlake (Our Last Night) $$
Run - Awolnation $$
Running Up That Hill - Kate Bush (Our Last Night) $$
Shape Of My Heart - Sting $$
Slow Dancing In The Dark - Joji () $$
Stay With Me - Miki Matsubara $$
Ur So Gay - Katy Perry $$
Wicked Game - Chris Isaac () $$
# Rock
Cinnamon Temple - Hiatus Kaiyote $$
Breath - Breaking Benjamin $$
Bullet With Butterfly Wings - The Smashing Pumpkins (Violet Orlandi) $$
Forty Six & 2 - Tool $$
Seven Nation Army - The White Stripes $$
Schism - Tool $$
Sonne - Rammstein $$
The Kill - 30 Seconds to Mars (Renascentia) $$
Welcome Home - Coheed and Cambria $$
# Instrumental
Diablo Lo-Fi $$
Man I Love Metal $$
Elegia - New World Order (MGSV Edit) $$
